------------------------------------------------------------------------------------------------------------------------------------==
------------------------------------------------------------------------------------------------------------------------------------==
------------------------------------------------------------------------------------------------------------------------------------==
------------------------------------------------------------------------------------------------------------------------------------==
------------------------------------------------------------------------------------------------------------------------------------==
==----------------------------------------------------------------------------------------------------------------------------------==
==---------------------------==--------------------------------------------------------------------------------------------------f--==
==-----p--------------------------------------------------------------------------------------------------------------------==========
==-----------------------==------------------------========--------------------------============-------------------------============
==----------------------------------------====--2--========--------------------------============------------------------=============
==---------------======-----------------===================--------===============-------------==--------------------=================
==->-------------=======------1---------===================--------===============-------------===-------------------=================
=================================--======================================================================---==========================
=================================!!======================================================================!!!==========================