------------------------------------------------------------------------------------------------------------------------------------==
------------------------------------------------------------------------------------------------------------------------------------==
------------------------------------------------------------------------------------------------------------------------------------==
------------------------------------------------------------------------------------------------------------------------------------==
------------------------------------------------------------------------------------------------------------------------------------==
==----------------------------------------------------------------------------------------------------------------------------------==
==---------------------------==--------------------------------------------------------------------------------------------------f--==
==-----p--------------------------------------------------------------------------------------------------------------------==========
==---------------^-------==------------------------========--------------------------============-------------------------============
==---------------?------------------------====--2--========--------------------------============------------------------=============
==-------0-------======-----/-----------===================--------===============-------------==--------------------=================
==->-----?-------=======----?-1---v-----===================--------===============-------------===-------------------=================
=================================--======================================================================---==========================
=================================!!======================================================================!!!==========================