--------------------------------------------------------------------------------------------------------------------------------==
--------------------------------------------------------------------------------------------------------------------------------==
--------------------------------------------------------------------------------------------------------------------------------==
--------------------------------------------------------------------------------------------------------------------------------==
--------------------------------------------------------------------------------------------------------------------------------==
==------------------------------------------------------------------------------------------------------------------------------==
==---------------------------==----------------------------------------------------------------------------------------------f--==
==-----p----------------------------------------------------------------------------------------------------------------==========
==-----------------------==--------------------========--------------------------============-------------------------============
==------------------1-----------------====-----========--------------------------============------------------------=============
==---------------======-------------===================--------===============-------------==--------------------=================
==---------------=======------------===================--------===============-------------===-------------------=================
=============================--======================================================================---==========================
=============================!!======================================================================!!!==========================