==----------------------------------------------------------==
==----------------------------------------------------------==
==----------------------------------------------------------==
==----------------------------------------------------------==
==----------------------------------------------------------==
==----------------------------------------------------------==
==------------------------------------1-----------2---f-----==
==---------------------------------=======---============---==
==---------------------------3------------------------------==
==-------------------===========----------------------------==
==-----------1---------------------------------------------==
==------===========-----------------------------------------==
==----------------------------------------------------------==
==!!--------------------------------------------------------==
=======-----------------------------------------------------==
==-------------------------------------------------=====----==
==---------3-----------!--!-----------------1---------------==
==------======---===============-----==============---------==
==----------------------------------------------------------==
==-----------------------------------2----------------------==
==-------------------------=====================------------==
==----------------------------------------------------------==
==----------------------------------------------------------==
==------------------=========-------------------------------==
==----------------------------------------------------------==
==---------------------------1------------------------------==
==------------------------=========---===----------------!--==
==---------------------------------------------------=====--==
==-----------------------------------2----------------------==
==-------------------------------====================-------==
==----------------------3-----------------------------------==
==---------------===============----------------------------==
==----------------------------------------------------------==
==---------!------------------------------------------------==
==--------=====---------------------------------------------==
==-------------!--------------------------------------------==
==-------------=======--=====-------------------------------==
==--------------------------------------!-------------------==
==----------------------------==================------------==
==---------p------------------------------------------------==
==--------------------1--------------------------------1----==
==------------===================--------------=========----==
==----------------------------------------3-----------------==
==!!--------------------------------============----------!!==
==============================================================
==============================================================