==----------------------------------------------------------==
==----------------------------------------------------------==
==----------------------------------------------------------==
==----------------------------------------------------------==
==----------------------------------------------------------==
==----------------------------------------------------------==
==------------------------------------------------2---f-----==
==---------------------------------=======---============---==
==----------------------------------------------------------==
==-------------------===========----------------------------==
==----------------------------------------------------------==
==------===========-----------------------------------------==
==----------------------------------------------------------==
==!!--------------------------------------------------------==
=======-----------------------------------------------------==
==-------------------------------------------------=====----==
==---------------------!--!-----------------1---------------==
==------======---===============-----==============---------==
==----------------------------------------------------------==
==----------------------------------------------------------==
==-------------------------=====================------------==
==----------------------------------------------------------==
==----------------------------------------------------------==
==------------------=========-------------------------------==
==----------------------------------------------------------==
==---------------------------1------------------------------==
==------------------------=========---===----------------!--==
==---------------------------------------------------=====--==
==-----------------------------------2----------------------==
==-------------------------------====================-------==
==----------------------------------------------------------==
==---------------===============----------------------------==
==----------------------------------------------------------==
==---------!------------------------------------------------==
==--------=====---------------------------------------------==
==-------------!--------------------------------------------==
==-------------=======--=====-------------------------------==
==--------------------------------------!-------------------==
==----------------------------==================------------==
==----------------------------------------------------------==
==--------p-----------1--------------------------------1----==
==------------===================--------------=========----==
==----------------------------------------------------------==
==!!--------------------------------============----------!!==
==============================================================
==============================================================